=========          =======
=X        $$==============
==XXXXXXX           XXXX==
====$$            ========
==              ==========